0 0 0 1 1 1 1
0 1 1 2 2 2 1
1 5 4 3 2 2 1
0 1 1 2 3 5 1
0 0 0 1 2 2 1
0 0 0 0 1 1 0