1 1 1 1 1 0 0
1 2 5 4 1 0 0
1 5 3 2 1 1 1
1 2 3 2 2 2 1
1 2 3 2 5 2 1
1 1 1 1 1 1 1